      NO         textures/no_matrix.xpm




             SO          textures/so_matrix.xpm
WE          textures/we_matrix.xpm




   EA textures/ea_matrix.xpm

    F                    220,100,0  







                C                     50,           50,80







        111111111
        100000001
11111111000111111
10000000000N000001
11111111000111111
        100000001
        111111111
