NO maps/wolftex/pics/wood.xpm
SO maps/wolftex/pics/redbrick.xpm
WE maps/wolftex/pics/eagle.xpm
EA maps/wolftex/pics/mossy.xpm

F 60,120,60
C 135,190,235

1111111111111111111
1001001001001001001
10010010S1001001001
1001001001001010010
1001001000001001001
1000000000000000001
1000011111111000001
1111111111111111111
1000000101110000001
1111111111111111111
